***************
*0*000000*000b*
*0*000000*0000*
*0***0000*0000*
*00000****0000*
*00000000*0000*
*0000000000000*
*0000000000000*
*000000*000000*
*00000***00000*
*000000*000000*
*000000000**00*
*0000000000*00*
*m000000000*00*
****************