***************
*00000**00000b*
**0*00*00*00***
*00*00*00*00*0*
**0*00000*00*0*
*00*000***0000*
*0**000*000**0*
*00*000*0*0*00*
*00*000***0000*
*****000000**0*
*0000**0000000*
*0**0***00**0**
*0*00000000000*
*m*000*000*000*
****************