***************
*000000000000b*
*0000000000000*
*0000000000000*
*0000000000000*
*0000000000000*
*0000000000000*
*0000000000000*
*0000000000000*
*0000000000000*
*0000000000000*
*0000000000000*
*0000000000000*
*m000000000000*
****************